###################
#0....#.....#....B#
#.###.#.###.#.###.#
#o#...#..o..#...#o#
#.#.#####.#####.#.#
#.#.....#.#.....#.#
#.#####.#.#.#####.#
#.....#.#.#.#.....#
##.#.#.#.#.#.#.#.##
#...#...P...#...I.#
#.###.#####.###.###
#.....#..o..#.....#
#.###.#.###.#.###.#
#C....#.....#....o#
###################
