%%%%%%%%%%%%%%%%%%%%%%%%%%%%%%%
%P....%...........%...........%
%.%%%.%.%%%%.%%%%.%.%%%%.%%%.%
%.....%....%....%...%....%....%
%.%%%%%%%%.%%%%.%%%%.%%%%%%%%.%
%.....%........%........%.....%
%.%%%.%.%%%%%%.%.%%%%%%.%.%%%.%
%....%.....%...%...%.....%....%
%%%%.%%%%%.%.%%%%%.%.%%%%%.%%%%
%....%.....%....o..%.....%....%
%.%%%.%.%%%%%%%%%%%%%.%.%%%.%%%
%...%...%.....%.....%...%.....%
%.%.%%%%%.%%%..%..%%%.%%%%%.%.%
%...%.....%....%....%.....%...%
%.%%%.%.%%%%.%%%%.%%%%.%.%%%.%%
%.....%....%........%....%.....%
%.%%%%%%%%.%.%%%%%%.%.%%%%%%%%.%
%....%.....%...%...%.....%..G.G%
%.%%%.%.%%%%%%.%.%%%%%%.%.%%%.%
%.....%........%........%.....o%
%%%%%%%%%%%%%%%%%%%%%%%%%%%%%%%
