%%%%%%%%%%%%%%%%%%%%
%P................G%
%..................%
%....o.............%
%..................%
%..........%%......%
%..................%
%G.............o...%
%%%%%%%%%%%%%%%%%%%%
