%%%%%%%%%%%%%%%%%%%%
%P....%....%....G..%
%.%%%.%.%%%.%.%%%.%%
%...%...%...%...%..%
%.%.%.%.%.%.%.%.%.%%
%..%...%...%...%...%
%%.%%%.%.%%%.%.%%%.%
%G....%....%....o..%
%%%%%%%%%%%%%%%%%%%%
